0, 0, 0, 0, 0, 0, 0, 0, 0, 0, 0, s, s, 0, 0, 0, 0, 0
0, 0, 0, 0, 0, 0, 0, 0, 0, 0, 0, s, s, 0, 0, 0, 0, 0
0, 0, 0, 0, 0, 0, 0, 0, 0, 0, 0, 0, 0, 0, 0, 0, 0, 0
0, 0, 0, 0, 0, 0, 0, 0, 0, 0, 0, 0, 0, 0, 0, 0, 0, 0
0, 0, 0, 0, 0, 0, 0, 0, 0, 0, 0, 0, 0, c, 0, a, X, 0
0, 0, 0, 0, 0, 0, 0, 0, 0, 0, 0, 0, 0, c, 0, a, 0, 0
0, 0, 0, 0, 0, 0, 0, 0, 0, 0, 0, 0, s, c, 0, a, 0, 0
0, 0, 0, 0, 0, 0, 0, 0, 0, 0, 0, 0, s, 0, 0, 0, 0, 0
0, 0, 0, 0, 0, 0, 0, 0, 0, 0, 0, 0, 0, 0, 0, 0, 0, 0
0, 0, 0, 0, 0, 0, 0, 0, 0, 0, 0, 0, 0, 0, 0, 0, 0, 0
