0, 0, 0, 0, 0, r, 0, 0, 0, 0, 0, 0, 0, r, 0, 0, 0, 0
0, 0, 0, 0, 0, r, 0, 0, 0, 0, 0, 0, 0, r, 0, 0, 0, 0
0, 0, 0, 0, 0, r, r, r, r, r, r, 0, 0, r, 0, 0, 0, 0
0, 0, 0, 0, 0, 0, 0, 0, m, 0, r, r, r, r, 0, 0, 0, 0
0, 0, 0, 0, 0, 0, 0, 0, m, 0, h, 0, 0, 0, 0, 0, 0, 0
0, 0, 0, 0, 0, 0, 0, 0, 0, 0, h, 0, 0, 0, 0, 0, 0, 0
0, 0, 0, 0, 0, 0, 0, h, 0, h, 0, 0, 0, 0, 0, 0, 0, 0
0, 0, 0, 0, 0, 0, 0, h, 0, 0, 0, 0, 0, 0, 0, 0, 0, 0
0, 0, 0, 0, 0, 0, 0, 0, m, 0, 0, 0, 0, 0, 0, 0, 0, 0
0, 0, 0, 0, 0, 0, 0, 0, m, 0, 0, 0, 0, 0, 0, 0, 0, 0
